15
15

North
East
South
West



***************
*             *
*      P      *
*             *
*             *
* ***     *** *
*/////////////*
*   **   **   *
*  ////////   *
*  ////////   *
*  *********  *
*/////////////*
*      D      *
***************
