22
11








    *****             
    *   *             
    *M  *             
  ***  M***           
  *  M  M *           
*** * *** *     ******
*   * *** *******  $$*
* M  M             $$*
***** **** *P****  $$*
    *      ***  ******
******** 