18
18

North
East
South
West



******************
*                *
*  *********     *
*  *CCC*  D*     *
*  *///* ***     *
*  *///$         *
*  *****         *
*                *
*         ***** **
*   MMM   * $$///*
*   M M   *CM$///*
*   M M   ** *****
*/////     ***   *
*/////           *
*                *
*                *
       P         *
******************