**********
*////////*
*////////*
*////////*
*//M/P///*
*$///////*
*///*////*
*///*/$//*
*$///////*
**********