22
11








**********************
*   *   *            *
*   *M  *            *
* ***  M***          *
* *  M  M *          *
*** *D*** *     ******
*   * *** *******    *
* M  M               *
***** **** *P****    *
*   *      ***  ******
**********************