**********
*$$$**$$$*
*/**$$**$*
*/////$*$*
*//M/P/*$*
*$////*$$*
*$/****$$*
*$$$**$$$*
*$$$$$$$$*
**********