**********
*//$*///$*
*///$$//$*
*/////$/$*
*//M/P/*$*
*$////*$$*
*$///////*
*$//*/$$$*
*$////$$$*
**********