17
17

North
East
South
West



*****************
*//////// M////D*
*//////// M/////*
*///MMMM/ M/////*
*   MCMM**M/////*
*$  M    *M/////*
*$  MMMMMM$$$$$$*
*$  ***   $/////*
*$  P *   $////C*
*****************

   $$$$$ $$$$$
   $     $   $
   $     $$$$$ 
   $     $
   $     $
   $$$$$ $