16
16

North
East
South
West



****************
*$$$ $$$ $$$   *
*$ $ $/$ $ $   *
* *       *    *
*              *
*              *
* **   **   ** *
*              *
*     *  *     *
*              *
*              *
*              *
*              *
*     *P*      *
*     ***      *
****************