12
12

North
East
South
West

DARKNESS

**********
*//////////*
*//////////*
*//////////*
*//M/P/////*
*$/////////*
*///*//////*
*///*/$////*
*$/////////*
*********//*