10
10

North
East
South
West

DARKNESS

**********
*//$*///$*
*///C$//$*
*/////$/$*
*//M/P/*D*
*$////*$ *
*$///////*
*$//*/$$$*
*$////$$$*
**********