10
10

North
East
South
West



**********
*     $ C*
* $$$ $  *
* $D$ $$$*
*  /     *
*        *
*        *
*** ******
*C   P$$$*
**********

  
  