20
20

North
East
South
West



********************
*//$*///$//////////*
*///C$//$$$$///////*
*/////$/$$C$///////*
*//M/P/*D$$$///////*
*$////*$$/M*///////*
*$////////*****////*
*$//*/$$$/*$$$*$$$$*
*$////$$$/*CM//$$***
*/////******/*******
*//////////////////*
*//////////////////*
*//////////////////*
*//*****************
*//////////////////*
*///////////////////
*////***************
*///*   *   *   ****
*//   *   *   *   D*
********************