$$$$$$$$$$
$$$$**$$$$
$$******$$
$$**//**$$
$$**/P**$$
$$$****$$$
$$$****$$$
$$$$**$$$$
$$$$$$$$$$
$$$$$$$$$$