$$$$$$$$$
$$$$$$$$$
$$*****$$
$$*****$$
$$**P**$$
$$$***$$$
$$$$$$$$$
$$$$$$$$$
$$$$$$$$$