$$$$$$$$$$
$$$$**$$$$
$$******$$
$$**PP**$$
$$**PP**$$
$$$****$$$
$$$****$$$
$$$$**$$$$
$$$$$$$$$$
$$$$$$$$$$